##################################
#S#             #               #
# # ########### # ############# #
# #             #               #
# # ############# ############# #
# #             #               #
# ############# # ############# #
# #             #               #
# ############# ############# # #
#               #               #
# ############# ############# # #
#               #               #
# ############# # ############# #
#               #               #
############### # ###############